yeet , A
yeet , B
yeet , C
yeet , E
yeet , G
acd , A
abc , A
abcd, A
B    , D
B    , H
A    , D
C    , L
D    , F
F    , H
I    , J
I    , K
I    , L
G    , H
K    , Y
G    , Y
A    , B
J    , L
